COPY	START	1000
FIRST	STL	RETADR
CLEAR	X
LDA	#3
LDB	#LENGTH
BASE	LENGTH
+JSUB	RDREC
LDA	@BUFFER
LDX	LENGTH,X
COMP	ZERO
JEQ	ENDFIL
TIXR	X
RSUB
TIO
ENDFIL	LDA	EOF
WLOOP	TD	OUTPUT
STA	BUFFER
HIO
SIO
RETADR	RESW	1
LENGTH	WORD	3
ZERO	WORD	0
BUFFER	RESB	4096
EOF	BYTE	C'EOF'
RDREC	RSUB
OUTPUT	BYTE	X'05'
END	START
